height 21
width 135
map
TTTTTTTTTTTTTTTTTTTTTTTTTTTTTTTTTTTTTTTTTTTTTTTTTTTTTTTTTTTTTTTTTTTTTTTTTTTTTTTTTTTTTTTTTTTTTTTTTTTTTTTTTTTTTTTTTTTTTTTTTTTTTTTTTTTTTTT
TTTTTTTTTTTTTTTTTTTTTTTTTTTTTTTTTTTTTTTTTTTTTTTTTTTTTTTTTTTTTTTTTTTTTTTTTTTTTTTTTTTTTTTTTTTTTTTTTTTTTTTTTTTTTTTTTTTTTTTTTTTTTT........T
TTTTTTTTT..................T.........T.........T...............................................T.........T.........T..................T
TTTT...TT..................T.........T.........................................................T.........T.........T..................T
TTTT.T.TT..................T.........T.........TTTTT...........................................T.........T.........T.................TT
TTTT.T.TT..................T.........T.........TTTTT...........................................T.........T.........T.................TT
TTTT.T.TT..................T.........T.........TTTTTTTTTTTTTTTT................................T.........T.........T..................T
TTTT.T.TT............................T.........TTTTT..........T..........................................T............................T
TTTT...TT..................TTTTTTTTT.TTTTTTTTT.TTTTT..........T.TTTTTTTTTTTTTTTTTTTTTTTTTTTTTT.TTTTTTTT..T.TTTTTTTTT..................T
T......TT..........................................TTTTT..TTTTT.......................................................................T
T.....................................................................................................................................T
T...TTTTTT..................TTTTTTTTTT.TTTTTTTTT..................TT........TTT..TTTTTTTTTTTTTT.TTTTTTTTTTTT.TTTTTTT..................T
T...TTTTT....................T.........TTTTTTTTTTT................TT...TTTTTTTT..TTTTTTT..........T...TTT..........T..................T
T...TTTTT....................T.........TTTTTTTTTTTTTTTTTTT.TT............TTTTTT..TTTTTTT.T.TT.........TTT..........T..................T
T...TTTTT....................T.....TT.T..T..................T............TTTTTT..TTTTTTT.T.TT.....T...TTTTTTT......T.................TT
T...TTTTT....................T.....TT....T...............................TT..........TTT.T.TT...TTTTTTTTTTTTT......T.................TT
TTTTTTTTT....................T.....TT....T..................T............TT...TTTT...TTT.T.TT.....T...TTTTTTT......T..................T
TTTTTTTTT....................T.....TTTTTTT..................T............TT.....T....TTT.T.TT.........TTTTTTT......T..................T
TTTTTTTTT....................T.....TTTTTTT..................T............TT.....T....TTT...TT.....T...TTTTTTT......TTTTTTTTTTT........T
TTTTTTTTTTTTTTTTTTTTTTTTTTTTTTTTTTTTTTTTTTTTTTTTTTTTTTTTTTTTTTTTTTTTTTTTTTTTTTTTTTTTTTTTTTTTT.....TTTTTTTTTTTTTTTTTTTTTTTTTTTTTTTTTTTTT
TTTTTTTTTTTTTTTTTTTTTTTTTTTTTTTTTTTTTTTTTTTTTTTTTTTTTTTTTTTTTTTTTTTTTTTTTTTTTTTTTTTTTTTTTTTTTTTTTTTTTTTTTTTTTTTTTTTTTTTTTTTTTTTTTTTTTTT