height 50
width 50
map
.T.T.T.....T..T..................T.T...TTTTT....TT
.T.T..TT.....T..TT....T.......TT.T.TT...TT.......T
.......TT..TT....T..T.TT.......TT..TTT.T.T.T.T..T.
...T.TTT.....T..T....T..TT.T.......T..........TT..
T.T...T.T...TT..T.T.T..T...TT.T..T.....T..TTT....T
...T....T...............T..TTT..TTT..TT....T......
.TT........T.T.T..T....TT.T....TT......T.T..T....T
..TTTT.....T.....TT....T.TT............TT...T....T
.T.T....T..........T...T.T..T.T.............T..T.T
.T.....TT...T..........T.TT..T.T..........T.T..TTT
...T...TT..........T.T.T...T....T.T..TT.....TTTT..
..TT....T.T...T..........T..T....TT..TTTTT.T.TTT..
..T..T..T.T......T..T.T.T.TT......T..TTTT.T......T
...T.........T..TT.........T.TT....T.TT.T...TT.T..
.......T...T.......TT..T.T..TT..T..........T..T.TT
T.T.TT...T...T..T....TT.......T.T...T..TT.T...T...
T...T....TT......TT.T..T......TT.T........T.T.T..T
TT.T...T...T........T..T.TT...T..T.TT...T...TT...T
...T...TT.TT.....T.T...T.TTT....T.....TT...T.T..TT
.......TT.T...TT.TT..T....TTT.....T..TT..........T
........T.....T..T.TT........TT..T.TTT...T......TT
...T....T..T....T..T...T.................T.T....TT
.....T.T...TT..T......TT..T.......T...T...T..T...T
...T.T...T..TT...T.....T...T.........T..T..T...TT.
T.....T.T....T..TT.........T..T.......T.T......T..
T..T.TT..T..T...T......T..T..T..T...T.TTTT.......T
.T.....T.........T.T.....T.T......T.T..TT..T.....T
.T.T....T..T..T.TT..............T.....T..TT.....TT
...TT.........TT...T....TTT..T......T......T......
.TTT..T...TT....T.T..T......T..T..T.........T.TTT.
....T.T..T..........T...T......T....TT..T.T.....TT
..TT....T.T..T..TTTTTT.T......TT.T.......TT......T
T...TT.T....T..T.T..T.T...TTT..T...T.T...TT.TT...T
.....T........T....T..T..TT.....T.......TT......TT
....TT.T.....T.T...T.....T.TT.T..T..T...T...T.T.TT
T.T.T.T..T...........TT..T.......T......T...T.T.TT
...TT..............T.T..T..T........T..TT...T.TTTT
.....T.TT...T...TTTTT....T........T.......T.T..TTT
.....T.........T..TT.T......T....TT....T.TT..TT.T.
.T..T..T...T..T...TT..T.T..T..T.....T.T..TTTT.....
.....T....T.T..T...T.TTTT.TTT....T.TTT.....T...TT.
.....T..T....T...........T....TT.....T.....T...T..
.T..........TTT....T...T......TTTT.TT...T.T..T.T..
T...T..TT.......T...TTTTT.T....TTT........T...TT.T
T...TTT.TTT.....T.T...T..T....T..T...T.T........T.
.....T...........TTT.TT...T.T...T.......T...T.....
.T....T...T......TTTTT..........T....T...T.TTT..T.
.TTTT.T.....T..T.........T....................T...
.T..TT..T.............T.........T.T........TT..T.T
....T....TT....T..T.T.T........TTTTT..T.T..TTT....
