height 5
width 9
map
.........
.E.S.S.E.
.E.T.T.E.
.E.S.S.E.
.........