height 21
width 35
map
...................................
.SS.ES.SSSSSSSSSS.SSSSSSSSSS.SE.SS.
.SE.SS.TTTTTTTTTT.TTTTTTTTTT.SS.SS.
.SS.SS.SSSSSSSSSS.SSSSSSSSSS.SE.SS.
.ES.SE.......................SE.SE.
.EE.SE.SSSSSSSSSS.SSSSSSSSSS.SE.SE.
.SS.SS.TTTTTTTTTT.TTTTTTTTTT.SS.ES.
.SS.ES.SSSSSSSSSS.SSSSSSSSSS.ES.ES.
.SE.ES.......................SS.ES.
.EE.SS.SSSSSSSSSS.SSSSSSSSSS.SE.EE.
.SS.ES.TTTTTTTTTT.TTTTTTTTTT.SE.SE.
.SS.SS.SSSSSSSSSS.SSSSSSSSSS.SE.SS.
.SS.SS.......................ES.ES.
.SE.SS.SSSSSSSSSS.SSSSSSSSSS.SE.ES.
.ES.SS.TTTTTTTTTT.TTTTTTTTTT.SS.SE.
.SS.SE.SSSSSSSSSS.SSSSSSSSSS.EE.EE.
.SS.ES.......................SS.SE.
.ES.SS.SSSSSSSSSS.SSSSSSSSSS.SS.SE.
.SS.SS.TTTTTTTTTT.TTTTTTTTTT.SS.ES.
.ES.ES.SSSSSSSSSS.SSSSSSSSSS.SS.EE.
...................................